11111111
1PEC0101
100000C1
11111111
