111111111111111111111111111111111111
101000000010001000100010000000000P01
10C000001000100010001000000000001111
111111111111111111111111111000000001
100000000000000000000000001000111101
11100000000010000000000000100010C101
100011110000111111111111111100100001
11101C010000000100010001000100111111
10CE0001000001000100010001000000C001
111111111111111111111111111111111111
