1111111111
1110000001
1C01101101
1C10001C01
10C0111001
1011E000P1
1111111111
